NO texture/jihyun_in_barcelona.xpm

SO texture/jihyun_in_granada.xpm
WE texture/jiyun_in_paris.xpm
EA texture/jiyun_in_venice.xpm

F 80,188,223
C 225,30,0


        1111111111111111111111111
        100000000011000000011101011 1 1  1 1 1 1
        1011000001110000000110001
        1001000000000000000110001
111111110011000001110000000000001  1
100000000011000001110111111101111
10110111111111011100000010001  1 1 1 1 1 1 1 1 1 1 1
11110111111111011101010010001
11000100110101011100000010001
10001E10000000001100000000001
100001000000000011010100101011
110000001001010010110111101001
10110111 1110101 1011110101011
11111111 1111111 111111111111

