






NO texture/jihyun_in_barcelona.xpm
SO texture/jihyun_in_granada.xpm
WE texture/jiyun_in_paris.xpm
EA texture/jiyun_in_venice.xpm

F 80,188,223
C 225,30,0

11111111
     11111111       111
                    1S11111111111111111111111
               1111111111111111          1111111111111111
11111111111111111111111111111111
               11111111     11111111     1111111111111111
          111111111111111111111111111111111111111
        11111111     111111111111111
111111111111111111111111111111111111111111111111111111111111111111111111111111111111111111111111
